11111111111111111111111111111111111111111111111111
10000000000000000000000000000000000000000000000001
10000000000000000000000000000000000000000000000001
10000000000000000000000000000000000000000000000001
1000000w00000000000000000000000000000000000v000001
10000000000000000000000000000000000000000000000001
10000000000000000000000000000000000000000000000001
1000000111111111111111BBBB1PPPP1BBBB11111111111111
10000001111111111111111111111111111111111111111111
1e000000000000000000000000000000000000000000000001
10000000000000000000000000000000000000000000000001
10000000000000000000000000000000000000000000000001
10000000000000000000000000000000000000000000000001
11100000009000000000000000000000000000000000000001
10000000000000000000000000000000000000000000000001
100000000000010000000000d000000d0000000000000000z1
11111111111111111111PPPPPPPPPPPPPPPPP1GGGG1BBBB111
11111111111111111111111111111111111111111111111111
10000000000000000000000000000000000000000000000001
1000000000000000000000000000000000000x000V00000001
10000000000000000000000000000000000000000000000001
1000000000000000000000000000000000000000000000q001
10000000000000000000000000000000000001111111111111
10000000000000000000000000000000000000000000000001
10000000000000000000000000000000110000000000000001
10000000000000000000000000000000000000000000000001
10000000000000000000000000000000000000000000000001
10000000000000000000000000110000000000000000000001
10000000000000000000000000000000000000000000000001
10000000000000000000000000000000000000000000000001
19000000000000000000110000000000000000000000000001
10000000000000000000000000000000000000000000000001
10000a00000000000000000000000000000000000000000001
11111111111111111GGGGGGGGGGGGGGGGGGGGGGGGGGGGGGGG1
11111111111111111111111111111111111111111111111111
