11111111111111111111111111111111111111111111111111
10000100000000000000000900000000000100000010000001
10000w00000000000000000000000000000w000000w00v0001
10000000000000000000000000000000000000000000000001
1000000000000z000000001111111000000000a00000000001
100001c0011111111111111w111w111d001111111111111111
10000100010000000000000000000000000000000000000001
10000100010000000000000000000000000000000000000001
11000100010000000000000000000000000000000000000001
100001000100000x00000000000000000c0000000000000001
100001c00100000000000000000000000000000000000000z1
1000z10001000000011111GGG1GGG11GGGGGGG111110000011
1000110001000001110001111x111111111111111110000001
10000100010000000000000000000000000000000010000001
100001c0010000000000000000000000000000000011000001
10000100011100000000000000000000000000000010000001
11000100010000000000000000000000000000000010000011
10000100010000000000000000000000000000000010000001
10000100010000010000000000000c00000000000010000001
1000010001BBBBB111BBBB111PPPPPPPPPP100000011000001
100011c0011111111111111111111111111100000010000001
10000100000000000000000000000000000000000010000001
10000100000000000000000000000000000000001110000011
1c001100000000000000000000000000000000000010000001
10000000000000000000000000000000000000000010000001
10000000000000000000000000000000000000000z11000001
1PPPPPPPP11111111111111GGG11111PPP1111111110000001
1111111111000000w000011111111111111111111110000001
10000000010000000000000000000000000000000010000001
10000000010000000000000000000000000000000010000011
1V0000000s0000c000009000000000000000000000x0000001
10000000000000000000000000000000000000000000000001
1000a0q0z0q000000000000000000000000000000000000001
11111111111GGGGGGGGG1111BBB1BBB1111111111111PPPPP1
11111111111111111111111111111111111111111111111111
